________________________________
________________________________
________________________________
________________________________
________________________________
________________________________
________________________________
________________________________
_________xxxxx_xxxxx____________
_________x___xxx___x____________
_________x_o_xEx_o_x____________
_______xxxxxnxLxnxxxxx__________
_______x_y_e_____d_y_x__________
_______x_o_xb_I_rx_o_x__________
_______xxxxxo_C_oxxxxx__________
_______x_o_xb___rx_o_x__________
_______x___d__o__e___x__________
_______xxxxxxwxwxxxxxx__________
___________x__x__x______________
___________x_oxo_x______________
___________x__xg_x______________
___________xxxxxxx______________
________________________________
________________________________
________________________________
________________________________
________________________________
________________________________
________________________________
________________________________
________________________________
________________________________