xxxxxxxxxxxxxxxxxxxxxxxxxxxxxxxx
x______B_______B_______________x
x______________________________x
x__BBBB______________B_________x
x____________BBB_______________x
x______________________________x
x______________________B_______x
x_______B_______C______________x
x______________________________x
x_______B______B_______________x
x______________________________x
x__________B___________B_______x
x______________________________x
x______________B_______________x
x______________________________x
x____________GGGGGGGGGGB_______x
x______________________________x
x______________________________x
x______________B_______________x
x______________GGGGGG__________x
x______________________________x
x______________________________x
x_________________B____________x
x______________________________x
x____BBBBBBBBBBBBB_____________x
x______________________________x
x______________________________x
x_________________B____________x
x______________________________x
x______________________________x
x______________________________x
xxxxxxxxxxxxxxxxxxxxxxxxxxxxxxxx