________________________________
________________________________
________________________________
________________________________
________________________________
________________________________
________________________________
________________________________
_________xxxxx_xxxxx____________
_________x_t_xxx___x____________
_________x_o_xEx_o_x____________
_______xxxxxnxLxnxxxxx__________
_______x_y_ezzzzzd_y_x__________
_______x_o_xb_I_rx_o_x__________
_______xxxxxo_C_oxxxxx__________
_______x_o_xb_p_rx_o_x__________
_______x_g_d__o__e___x__________
_______xxxxxxwxwxxxxxx__________
___________x__x__x______________
___________x_oxo_x______________
___________x__xgsx______________
___________xxxxxxx______________
________________________________
________________________________
________________________________
________________________________
________________________________
________________________________
________________________________
________________________________
________________________________
________________________________